R 1920 1080
NO ./greystone.xpm
SO ./purplestone.xpm
WE ./wood.xpm
EA ./redbrick.xpm
S ./greystone.xpm
F 250,190,140
C 90,250,170
1111111111111111111111111
1000000000110000000000001
1011000001110000002000001
100100000000000000000000111111111
111111111011000001110000000001001
100000000011000001110111011110111
11110111111111011100000010000000011
111101111111110111010101000110000001
11000000110101011100000010000000011
10002000000000001100000010000000001
10000000000000001101010010000000011
11000001110101011111011110001S100011
11110111 1110101 101111010000000001
11111111 1111111 111111111111111111
