R 1920 1080
NO ./path_to_the_north_texture
SO ./path_to_the_south_texture
WE ./path_to_the_west_texture
EA ./path_to_the_east_texture
S ./path_to_the_sprite_texture
F 250,190,140
C 90,250,170
1111111111111111111111111
1000000000110000000000001
1011000001110000002000001
1001000000000000000000001
111111111011000001110000000000001
100000000011000001110111111111111
1111011111111101110000001000000001
1111011111111101110101001000000001
1100000011010101110000001000000001
1000200000000000110000001000000001
10000000000000001101010010000000011
11000001110101011111011110000N000011
11110111 1110101 101111010000000001
11111111 1111111 111111111111111111
