R 800 470
NO               ./greystone.xpm









SO ./purplestone.xpm
WE ./wood.xpm



S ./barrel.xpm


EA ./redbrick.xpm
F 250,191,140
C 90,25,170

111111111111111111111111
1000100000110000000000001
1011000001110000000000001
100100000000000000000000111111111
1111111110110000011100000000000201
100000000011000001110111011110111
11110111111111011100001010000000011
111101111111110111010101000112000001
11000000110101011100000010000200011
10000000000000001100000010000200001
100000000000000011010100100000000111
110000011101010111110111100010100011
1111011111110101110111101000N0000011
11111111111111111111111111111111112
11