R 500 100
NO ./greystone.xpm
SO ./purplestone.xpm
WE ./wood.xpm
EA ./redbrick.xpm
S ./barrel.xpm
F 250,190,140
C 90,250,170
1111111111111111111111111
1000000000110000000000001
1011000001110000000000001
100100000000000000000000111111111
111111111011000001110000000000021
100000000011000001110111011110111
11110111111111011100000010000000011
111101111111110111010101000112000001
11000000110101011100000010000200011
10000000000000001100000010000200001
10000000000000001101010010000000011
11000001110101011111011110001N100011
11110111 1110101 101111010000000001
11111111 1111111 111111111111111111
