R 1300 760
NO ./textures/greystone.xpm
SO ./textures/purplestone.xpm
WE ./textures/wood.xpm
S ./textures/barrel.xpm
EA ./textures/redbrick.xpm
F 250,191,140
C 90,25,170

11111111111111111111111111111111111
11110111111111000000001010000000011
11112111111111011101010100011200001
11000002110101011100000010000200011
10000000000000001100000010000200001
100002000000000011010100000000000111
110000011101010111110111100010100011
1111011111110101110011101000N0000011
11111111111111111111111111111111112
